"a" = (/turf,/area)
"b" = (/turf/Mountains/jap33,/area)
"c" = (/turf/Mountains/jap15,/area)
"d" = (/mob/Enemies/Angry_Bat,/turf/Mountains/jap15,/area)
"e" = (/mob/Enemies/Bandit_Enemies/Cave_Bandit,/turf/Mountains/jap15,/area)
"f" = (/turf/Mountains/jap15,/turf/EnemyStop,/area)
"g" = (/turf/Mountains/jap33,/turf/EnemyStop,/area)
"h" = (/mob/Enemies/Bat,/turf/Mountains/jap15,/area)
"i" = (/mob/Enemies/Bandit_Enemies/Cave_Bandit_Leader,/turf/Mountains/jap15,/area)
"j" = (/turf/Mountains/jap15,/turf/Markers/Mountains/Dungeon1_Inside,/area)
"k" = (/turf/Mountains/jap15,/turf/Locations/Dungeons/Dungeon1_Outside,/area)

(1,1,1) = {"
aaaaaaaaaaaaaaaaaaaaaaaaaaaaaaaaaaaaaaaaaaaaaaaaaaaaaaaaaaaaaaaaaaaaaa
aaaaaaaaaaaaaaaaaaaaaaaaaaaaaaaaaaaaaaaaaaaaaaaaaaaaaaaaaaaaaaaaaaaaaa
aaaaaaaaaaaaaaaaaaaaaaaaaaaaaaaaaaaaaaaaaaaaaaaaaaaaaaaaaaaaaaaaaaaaaa
aaaaaaaaaaaaaaaaaaaaaaaaaaaaaaaaaaaaaaaaaaaaaaaaaaaaaaaaaaaaaaaaaaaaaa
aaaaaaaaaaaaaaaaaaaaaaaaaaaaaaaaaaaaaaaaaaaaaaaaaaaaaaaaaaaaaaaaaaaaaa
aaaaaaaaaaaaaaaaaaaaaaaaaaaaaaaaaaaaaaaaaaaaaaaaaaaaaaaaaaaaaaaaaaaaaa
aaaaaaaaaaaaaaaaaaaaaaaaaaaaaaaaaaaaaaaaaaaaaaaaaaaaaaaaaaaaaaaaaaaaaa
aaaaaaaaaaaaaaaaaaaaaaaaaabbbbbbbbbbbbbbbbbbbaaaaaaaaaaaaaaaaaaaaaaaaa
aaaaaaaaaaaaaaaaaaaaaaaaaabcccccccccccccccccbaaaaaaaaaaaaaaaaaaaaaaaaa
aaaaaaaaaaaaaaaaaaaaaaaaaabcccccccccccccccccbaaaaaaaaaaaaaaaaaaaaaaaaa
aaaaaaaaaaaaaaaaaaaaaaaaaabccdccccccccecccccbaaaaaaaaaaaaaaaaaaaaaaaaa
aaaaaaaaaaaaaaaaaaaaaaaaaabcccccccccccccccccbaaaaaaaaaaaaaaaaaaaaaaaaa
aaaaaaaaaaaaaaaaaaaaaaaaaabcccccccccccccccccbaaaaaaaaaaaaaaaaaaaaaaaaa
aaaaaaaaaaaaaaaaaaaaaaaaaabcccccccdcccccccccbaaaaaaaaaaaaaaaaaaaaaaaaa
aaaaaaaaaaaaaaaaaaaaaaaaaabcccccccccccccccccbaaaaaaaaaaaaaaaaaaaaaaaaa
aaaaaaaaaaaaaaaaaaaaaaaaaabcccccccccccccccccbaaaaaaaaaaaaaaaaaaaaaaaaa
aaaaaabbbbbbbbbbbaaaaaaaaabcccecccccccecccccbaaaaaaaaaaaaaaaaaaaaaaaaa
aaaaaabcccccccccbaaaaaaaaabcccccccccccccccccbaaaaaaaaaaaaaaaaaaaaaaaaa
aaaaaabccccccdccbaaaaaaaaabbbbbbbbffbbbbbbbbbaaaaaaaaaaaaaaaaaaaaaaaaa
aaaaaabcccccccccbaaaaaaaaaaaaaaaabccbaaaaaaaaaaaaaaaaaaaaaaaaaaaaaaaaa
aaaaaabccdccccccbaaaaaaaaaaaaaaaabccbaaaaaaaaaaaaaaaaaaaaaaaaaaaaaaaaa
aaaaaabcccccccccbaaaaaaaaaaaaaaaabccbaaaaaaaaaaaaaaaaaaaaaaaaaaaaaaaaa
aaaaaabcccccccccbaaaaaaaaaaaaaaaabccbaaaaaaaaaaaaaaaaaaaaaaaaaaaaaaaaa
aaaaaabcccccdcccbaaaaaaaaaaaaaaaabccbaaaaaaaaaaaaaaaaaaaaaaaaaaaaaaaaa
aaaaaabcccccccccbaaaaaaaaaaaaaaaabccbaaaaaaaaaaaaaaaaaaaaaaaaaaaaaaaaa
aaaaaabbbbfffbbbbaaaaaaaaaaaabbbbbffbbbbbbaaaaaaaaaaaaaaaaaaaaaaaaaaaa
aaaaaaaaabcccbaaaaaaaaaaaaaaabcccccccccccbaaaaaaaaaaaaaaaaaaaaaaaaaaaa
aaaaaaaaabcccbaaaaaaaaaaaaaaabcccccccccccbaaaaaaaaaaaaaaaaaaaaaaaaaaaa
aaaaaaaaabcccbaaaaaaaaaaaaaaabcccccccecccbaaaaaaaaaaaaaaaaaaaaaaaaaaaa
aaaaaaaaabcccbbbbbbbbbbbbbbbbbcceccccccccbaaaaaaaaaaaaaaaaaaaaaaaaaaaa
aaaaaaaaabcccccccccccccccccccfcccccccccccbbbbbbbbbbbbbbaaaaaaaaaaaaaaa
aaaaaaaaabcccccccccccccccccccfcccccccccccfccccccccccccbaaaaaaaaaaaaaaa
aaaaaaaaabcccccccccccccccccccfcccccecccccfccccccccccccbaaaaaaaaaaaaaaa
aaaaaaaaabcccccccccccccccccccfcccccccccccbbbbbbbbfffffgaaaaaaaaaaaaaaa
aaaaaaaaabbbbbbccbbbbbbbbbbbbbcccccccccccbaaaaaabcccccbaaaaaaaaaaaaaaa
aaaaaaaaaaaaaabccbaaaaaaaaaaabcccccccccccbaaaaaabcecccbaaaaaaaaaaaaaaa
aaaaaaaaaaaaaabccbaaaaaaaaaaabcceccccccccbaaaaaabcccecbaaaaaaaaaaaaaaa
aaaaaaaaaabbbbbffbbbbbaaaaaaabcccccccccccbaaaaabbcccccbaaaaaaaaaaaaaaa
aaaaaaaaaabccccccccccbaaaaaaabcccccccccccbaaaaabccccccbaaaaaaaaaaaaaaa
aaaaaaaaaabcchcccccccbaaaaaaabcccccccccccbaaaaabccicccbaaaaaaaaaaaaaaa
aaaaaaaaaabcccccccchcbaaaaaaabcccccccecccbaaaaabccccccbaaaaaaaaaaaaaaa
aaaaaaaaaabccccchccccbaaaaaaabcccccccccccbaaaaabccccccbaaaaaaaaaaaaaaa
aaaaaaaaaabccccccccccbaaaaaaabcccccccccccbaaaaabbbbbbbbaaaaaaaaaaaaaaa
aaaaaaaaaabcchcccccccbaaaaaaabcccccccccccbaaaaaaaaaaaaaaaaaaaaaaaaaaaa
aaaaaaaaaabccccccccccbaaaaaaabcccccccccccbaaaaaaaaaaaaaaaaaaaaaaaaaaaa
aaaaaaaaaabffbbbbbbbbbaaaaaaabbbbbbbbbbbbbaaaaaaaaaaaaaaaaaaaaaaaaaaaa
aaaaaaaaaabccbaaaaaaaaaaaaaaaaaaaaaaaaaaaaaaaaaaaaaaaaaaaaaaaaaaaaaaaa
aaaaaaaaaabccbaaaaaaaaaaaaaaaaaaaaaaaaaaaaaaaaaaaaaaaaaaaaaaaaaaaaaaaa
aaaaaaaaaabccbaaaaaaaaaaaaaaaaaaaaaaaaaaaaaaaaaaaaaaaaaaaaaaaaaaaaaaaa
aaaaaaabbbbccbbbaaaaaaaaaaaaaaaaaaaaaaaaaaaaaaaaaaaaaaaaaaaaaaaaaaaaaa
aaaaaaabcccccccbaaaaaaaaaaaaaaaaaaaaaaaaaaaaaaaaaaaaaaaaaaaaaaaaaaaaaa
aaaaaaabcccccccbaaaaaaaaaaaaaaaaaaaaaaaaaaaaaaaaaaaaaaaaaaaaaaaaaaaaaa
aaaaaaabcccccccbaaaaaaaaaaaaaaaaaaaaaaaaaaaaaaaaaaaaaaaaaaaaaaaaaaaaaa
aaaaaaabcccccccbaaaaaaaaaaaaaaaaaaaaaaaaaaaaaaaaaaaaaaaaaaaaaaaaaaaaaa
aaaaaaabcccccccbaaaaaaaaaaaaaaaaaaaaaaaaaaaaaaaaaaaaaaaaaaaaaaaaaaaaaa
aaaaaaabcccccccbaaaaaaaaaaaaaaaaaaaaaaaaaaaaaaaaaaaaaaaaaaaaaaaaaaaaaa
aaaaaaabcccjcccbaaaaaaaaaaaaaaaaaaaaaaaaaaaaaaaaaaaaaaaaaaaaaaaaaaaaaa
aaaaaaabbbbkbbbbaaaaaaaaaaaaaaaaaaaaaaaaaaaaaaaaaaaaaaaaaaaaaaaaaaaaaa
aaaaaaaaaaaaaaaaaaaaaaaaaaaaaaaaaaaaaaaaaaaaaaaaaaaaaaaaaaaaaaaaaaaaaa
aaaaaaaaaaaaaaaaaaaaaaaaaaaaaaaaaaaaaaaaaaaaaaaaaaaaaaaaaaaaaaaaaaaaaa
aaaaaaaaaaaaaaaaaaaaaaaaaaaaaaaaaaaaaaaaaaaaaaaaaaaaaaaaaaaaaaaaaaaaaa
aaaaaaaaaaaaaaaaaaaaaaaaaaaaaaaaaaaaaaaaaaaaaaaaaaaaaaaaaaaaaaaaaaaaaa
aaaaaaaaaaaaaaaaaaaaaaaaaaaaaaaaaaaaaaaaaaaaaaaaaaaaaaaaaaaaaaaaaaaaaa
aaaaaaaaaaaaaaaaaaaaaaaaaaaaaaaaaaaaaaaaaaaaaaaaaaaaaaaaaaaaaaaaaaaaaa
aaaaaaaaaaaaaaaaaaaaaaaaaaaaaaaaaaaaaaaaaaaaaaaaaaaaaaaaaaaaaaaaaaaaaa
"}
