"aa" = (/turf/Mountains/s11,/area)
"ab" = (/turf/Mountains/s12,/area)
"ac" = (/turf/Mountains/s12,/turf/Mountains/pl11,/area)
"ad" = (/turf/Mountains/s12,/turf/Mountains/pl2,/area)
"ae" = (/turf/Mountains/s9,/turf/Mountains/pl5,/area)
"af" = (/turf/Mountains/s9,/turf/Mountains/pl9,/area)
"ag" = (/turf/Mountains/s10,/area)
"ah" = (/turf/Mountains/s8,/area)
"ai" = (/turf/Mountains/s9,/area)
"aj" = (/turf/Mountains/s9,/turf/Mountains/pl2,/area)
"ak" = (/turf/Mountains/s9,/turf/Mountains/pl11,/area)
"al" = (/turf/Mountains/s4,/turf/Mountains/pl9,/area)
"am" = (/turf/Mountains/s9,/turf/Mountains/pl11{layer = 20},/area)
"an" = (/turf/Mountains/s9,/turf/Mountains/pl11{layer = 10},/area)
"ao" = (/turf/Mountains/s5,/area)
"ap" = (/turf/Mountains/s6,/area)
"aq" = (/turf/Mountains/s6,/turf/Mountains/pl9,/area)
"ar" = (/turf/Mountains/s6,/turf/Mountains/pl5,/area)
"as" = (/turf/Mountains/s7,/area)
"at" = (/turf/Mountains/m8{m = "suicideshifter"; suffix = ""; tag = "t"},/area)
"au" = (/turf/Mountains/m8,/area)
"av" = (/turf/Mountains/m9,/area)
"aw" = (/turf/Mountains/m3,/area)
"ax" = (/turf/Mountains/m7,/area)
"ay" = (/turf/Mountains/m8,/turf/Mountains/pl10,/area)
"az" = (/turf/Mountains/m1,/area)
"aA" = (/turf/Mountains/m2,/area)
"aB" = (/turf/Mountains/m2,/turf/Mountains/pl10,/area)
"aC" = (/turf/Mountains/mg7,/area)
"aD" = (/turf/Mountains/mg8,/area)
"aE" = (/mob/NPCS/Tailor,/turf/Mountains/mg7,/area)
"aF" = (/obj/Tent,/turf/Mountains/mg7,/area)
"aG" = (/turf/Mountains/br2,/turf/Markers/Shaolin/Shaolin_Test/Level_1_Enter,/area)
"aH" = (/turf/Mountains/s9,/turf/Markers/VillageOne/Spawn,/area)
"aI" = (/turf/Mountains/br1,/turf/Markers/Shaolin/Shaolin_Test/Level_1_Enter,/area)
"aJ" = (/mob/NPCS/Clan_Creator,/turf/Mountains/mg7,/area)
"aK" = (/obj/Tent,/turf/Mountains/s9,/area)
"aL" = (/mob/NPCS/QUEST/Monk,/turf/Mountains/s9,/area)
"aM" = (/obj/Items/Weapons/Wooden_Sword,/turf/Mountains/s9,/area)
"aN" = (/turf/Mountains/s11,/turf/EnemyStop{D = 1; name = "Player&EnemyStop"},/area)
"aO" = (/turf/Mountains/s12,/turf/Mountains/pl5,/turf/EnemyStop{D = 1; name = "Player&EnemyStop"},/area)
"aP" = (/turf/Mountains/s12,/turf/EnemyStop{D = 1; name = "Player&EnemyStop"},/area)
"aQ" = (/turf/Mountains/s13,/turf/EnemyStop{D = 1; name = "Player&EnemyStop"},/area)
"aR" = (/turf/Mountains/s13,/turf/Mountains/pl11,/turf/EnemyStop{D = 1; name = "Player&EnemyStop"},/area)
"aS" = (/mob/NPCS/BlackSmith,/turf/Mountains/mg7,/area)
"aT" = (/turf/Mountains/s8,/turf/EnemyStop{D = 1; name = "Player&EnemyStop"},/area)
"aU" = (/turf/Mountains/s9,/turf/Mountains/pl11,/turf/EnemyStop{D = 1; name = "Player&EnemyStop"},/area)
"aV" = (/turf/Mountains/s9,/turf/EnemyStop{D = 1; name = "Player&EnemyStop"},/area)
"aW" = (/turf/Mountains/s10,/turf/EnemyStop{D = 1; name = "Player&EnemyStop"},/area)
"aX" = (/turf/Mountains/s9,/turf/Mountains/pl5,/turf/EnemyStop{D = 1; name = "Player&EnemyStop"},/area)
"aY" = (/turf/Mountains/s4,/turf/Mountains/pl9,/turf/EnemyStop{D = 1; name = "Player&EnemyStop"},/area)
"aZ" = (/turf/Mountains/s12,/turf/Mountains/pl11,/turf/EnemyStop{D = 1; name = "Player&EnemyStop"},/area)
"ba" = (/turf/Mountains/s12,/turf/Mountains/pl2,/turf/EnemyStop{D = 1; name = "Player&EnemyStop"},/area)
"bb" = (/turf/Mountains/s9,/turf/Mountains/pl9,/turf/EnemyStop{D = 1; name = "Player&EnemyStop"},/area)
"bc" = (/turf/Mountains/s9,/turf/Mountains/pl2,/turf/EnemyStop{D = 1; name = "Player&EnemyStop"},/area)
"bd" = (/turf/Mountains/s12,/turf/Mountains/pl4,/turf/EnemyStop{D = 1; name = "Player&EnemyStop"},/area)
"be" = (/turf/Mountains/s3,/turf/EnemyStop{D = 1; name = "Player&EnemyStop"},/area)
"bf" = (/turf/Mountains/s9,/turf/Mountains/pl11{layer = 20},/turf/EnemyStop{D = 1; name = "Player&EnemyStop"},/area)
"bg" = (/turf/Mountains/s9,/turf/Mountains/pl11{layer = 10},/turf/EnemyStop{D = 1; name = "Player&EnemyStop"},/area)
"bh" = (/turf/Mountains/s5,/turf/EnemyStop{D = 1; name = "Player&EnemyStop"},/area)
"bi" = (/turf/Mountains/s6,/turf/EnemyStop{D = 1; name = "Player&EnemyStop"},/area)
"bj" = (/turf/Mountains/s6,/turf/Mountains/pl5,/turf/EnemyStop{D = 1; name = "Player&EnemyStop"},/area)
"bk" = (/turf/Mountains/s7,/turf/EnemyStop{D = 1; name = "Player&EnemyStop"},/area)
"bl" = (/turf/Mountains/m1,/turf/EnemyStop{D = 1; name = "Player&EnemyStop"},/area)
"bm" = (/turf/Mountains/m8,/turf/EnemyStop{D = 1; name = "Player&EnemyStop"},/area)
"bn" = (/turf/Mountains/m3,/turf/EnemyStop{D = 1; name = "Player&EnemyStop"},/area)
"bo" = (/turf/Mountains/mg11,/turf/EnemyStop{D = 1; name = "Player&EnemyStop"},/area)
"bp" = (/turf/Mountains/mg12,/turf/EnemyStop{D = 1; name = "Player&EnemyStop"},/area)
"bq" = (/turf/Mountains/mg12,/turf/Mountains/pl3,/turf/EnemyStop{D = 1; name = "Player&EnemyStop"},/area)
"br" = (/turf/Mountains/mg12,/turf/Mountains/pl4,/turf/EnemyStop{D = 1; name = "Player&EnemyStop"},/area)
"bs" = (/turf/Mountains/mg13,/turf/EnemyStop{D = 1; name = "Player&EnemyStop"},/area)
"bt" = (/turf/EnemyStop{D = 1; name = "Player&EnemyStop"},/area)
"bu" = (/turf/Mountains/mg6,/area)
"bv" = (/turf/Mountains/mg7,/turf/Mountains/pl2,/area)
"bw" = (/mob/Enemies/Fox,/turf/Mountains/s9,/area)
"bx" = (/turf/Mountains/mg8,/turf/EnemyStop{D = 1; name = "Player&EnemyStop"},/area)
"by" = (/turf,/area)
"bz" = (/turf/Mountains/mg2,/area)
"bA" = (/turf/Mountains/mg2,/turf/Mountains/pl1,/area)
"bB" = (/mob/Enemies/Fox,/turf/Mountains/mg2,/area)
"bC" = (/turf/Mountains/m7,/turf/EnemyStop{D = 1; name = "Player&EnemyStop"},/area)
"bD" = (/turf/Mountains/m9,/turf/EnemyStop{D = 1; name = "Player&EnemyStop"},/area)
"bE" = (/turf/Mountains/mg7,/turf/EnemyStop,/area)
"bF" = (/turf/Mountains/s9,/turf/EnemyStop,/area)
"bG" = (/turf/Mountains/m2,/turf/Mountains/pl11,/turf/EnemyStop{D = 1; name = "Player&EnemyStop"},/area)
"bH" = (/turf/Mountains/m2,/turf/EnemyStop{D = 1; name = "Player&EnemyStop"},/area)
"bI" = (/turf/Mountains/mg7,/turf/EnemyStop{D = 1; name = "Player&EnemyStop"},/area)
"bJ" = (/turf/Mountains/mg7,/turf/Mountains/pl9,/area)
"bK" = (/turf/Mountains/tg5,/area)
"bL" = (/turf/Mountains/tg11,/turf/Mountains/pl9,/area)
"bM" = (/turf/Mountains/tg11,/area)
"bN" = (/turf/Mountains/tg8,/turf/Mountains/pl9,/area)
"bO" = (/turf/Mountains/mg7,/turf/Mountains/pl5,/area)
"bP" = (/turf/Mountains/mg7,/turf/Mountains/pl3,/area)
"bQ" = (/turf/Mountains/tg3,/area)
"bR" = (/turf/Mountains/tg4,/area)
"bS" = (/turf/Mountains/mg6,/turf/EnemyStop,/area)
"bT" = (/mob/Enemies/Wolf,/turf/Mountains/s9,/area)
"bU" = (/turf/Mountains/s9,/turf/Markers/Shaolin/Shaolin_Test/Level_1_Back,/area)
"bV" = (/mob/Enemies/Wolf,/turf/Mountains/mg7,/area)
"bW" = (/turf/Mountains/mg2,/turf/EnemyStop{D = 1; name = "Player&EnemyStop"},/area)
"bX" = (/turf/Mountains/mg3,/area)
"bY" = (/turf/Mountains/mg6,/turf/EnemyStop{D = 1; name = "Player&EnemyStop"},/area)
"bZ" = (/turf/Mountains/mg1,/turf/EnemyStop{D = 1; name = "Player&EnemyStop"},/area)
"ca" = (/turf/Mountains/mg2,/turf/Mountains/pl2,/area)
"cb" = (/turf/Mountains/mg3,/turf/EnemyStop{D = 1; name = "Player&EnemyStop"},/area)
"cc" = (/turf/Mountains/mg13,/turf/EnemyStop,/area)
"cd" = (/turf/Mountains/s9,/turf/Markers/Shaolin/Shaolin_Test/Level_2_Enter,/area)
"ce" = (/mob/Enemies/Bandit_Enemies/Bandit,/turf/Mountains/s9,/area)
"cf" = (/turf/Mountains/mg8,/turf/EnemyStop,/area)
"cg" = (/turf/Mountains/w6,/area)
"ch" = (/turf/Mountains/mg11,/area)
"ci" = (/turf/Mountains/mg12,/area)
"cj" = (/turf/Mountains/mg12,/turf/Mountains/pl11,/area)
"ck" = (/turf/Mountains/mg8,/turf/Mountains/pl9,/area)
"cl" = (/turf/Mountains/w1,/area)
"cm" = (/turf/Mountains/mg7,/turf/Mountains/pl11,/area)
"cn" = (/mob/Enemies/Fox,/turf/Mountains/mg5,/area)
"co" = (/turf/Mountains/mg2,/turf/Mountains/pl3,/area)
"cp" = (/turf/Mountains/mg4,/area)
"cq" = (/turf/Mountains/mg7,/turf/Mountains/pl5,/turf/Mountains/pl9,/area)
"cr" = (/mob/Enemies/Fox,/turf/Mountains/mg7,/area)
"cs" = (/turf/Mountains/mg1,/area)
"ct" = (/turf/Mountains/mg2,/turf/Mountains/pl5,/area)
"cu" = (/turf/Mountains/m2,/turf/Mountains/pl11,/area)
"cv" = (/turf/Mountains/m3,/turf/Mountains/pl11,/area)
"cw" = (/turf/Mountains/m1,/turf/Mountains/pl11,/area)
"cx" = (/turf/Mountains/Black,/turf/Locations/Dungeons/Dungeon1_Inside,/area)
"cy" = (/turf/Mountains/tg12,/area)
"cz" = (/turf/Mountains/m2,/turf/Mountains/pl10,/turf/Mountains/pl11,/area)
"cA" = (/turf/Mountains/tg11,/turf/Mountains/pl1,/turf/Mountains/pl9,/area)
"cB" = (/turf/Mountains/tg11,/turf/Markers/Mountains/Dungeon1_Outside,/area)
"cC" = (/mob/NPCS/Traveler,/turf/Mountains/tg11,/area)
"cD" = (/turf/Mountains/tg2,/area)
"cE" = (/turf/Mountains/p3,/area)
"cF" = (/turf/Mountains/p4,/turf/Mountains/pl5,/area)
"cG" = (/turf/Mountains/mg7,/turf/Markers/Shaolin/Shaolin_Test/To_Shaolin_Monk,/area)
"cH" = (/turf/Mountains/p1,/area)
"cI" = (/turf/Mountains/p2,/area)
"cJ" = (/turf/Mountains/br2,/area)
"cK" = (/turf/Mountains/br2,/turf/Markers/Shaolin/Shaolin_Test/Level_2_Back,/area)
"cL" = (/turf/Mountains/s9,/turf/Markers/Shaolin/Shaolin_Test/To_Shaolin_Monk,/area)
"cM" = (/turf/Mountains/mg7,/turf/Mountains/pl1,/area)
"cN" = (/turf/Mountains/br1,/area)
"cO" = (/turf/Mountains/br1,/turf/Markers/Shaolin/Shaolin_Test/Level_2_Back,/area)
"cP" = (/turf/Mountains/tg13,/area)
"cQ" = (/turf/Mountains/tg15,/area)
"cR" = (/turf/Mountains/tg16,/area)
"cS" = (/turf/Mountains/tg10,/turf/Mountains/pl5,/area)
"cT" = (/turf/Mountains/tg14,/area)
"cU" = (/turf/Mountains/tg10,/area)
"cV" = (/turf/Mountains/tg11,/turf/Mountains/pl5,/area)
"cW" = (/turf/Mountains/s12,/turf/Mountains/pl5,/area)
"cX" = (/turf/Mountains/s13,/area)
"cY" = (/turf/Mountains/s13,/turf/Mountains/pl11,/area)
"cZ" = (/turf/Mountains/tg11,/turf/Mountains/pl11,/area)
"da" = (/turf/Mountains/tg11,/turf/Mountains/pl1,/area)
"db" = (/turf/Mountains/tg11,/turf/Mountains/pl2,/area)
"dc" = (/turf/Mountains/s12,/turf/Mountains/pl4,/area)
"dd" = (/turf/Mountains/s3,/area)

(1,1,1) = {"
aaabacababababacabababababadacabababababacabababababaeafag
ahaiafaiajaiaiafaiaiaiakaiaiafaeaiaiaiaialaiaiaiaiaiamaeag
ahaiaiaiaiaiaiaiakaiaiafaiaiaiaiakaiaiaiaiaiaianaiaiafaiag
ahaiaiakaiaiaiaiafaiaiaiaiakaiaiafaiaiakaiaiaiafaiaiaiaiag
aoapapafapapapapapapapapapaqapapapapapafarapapapapapapapas
ahaiaiaiaiagatauauavauauauavauauauauauauauauauauauavauauaw
ahaiaiaiaiagauauauavauauauavauauauavauauauavauauauavauauav
aoapapapapasauauauavaxayayavazaAaBawazaAaAawaxayayavaxauav
axauauauauavaAaAaAawazayayawaCaCaCaCaCaCaCaCazaAaAawazaAaw
axauauauauavaiaCaCaCaCaCaCaCaCaCaCaCaCaCaCaCaCaCaCaCaCaCaD
axauauauauavaiaCaCaCaCaCaCaCaCaEaCaFaCaCaCaCaCaCaCaCaCaCaD
axauauauauavaiaCaCaCaCaCaCaCaCaCaCaCaiaCaCaCaCaCaCaCaCaiaG
axauauauauavaiaiaCaCaCaCaCaiaiaiaHaiaiaiaiaiaiaiaiaiaiaiaI
axauauauauavaCaiaCaJaiaKaiaiaLaCaiaCaCaCaCaCaCaCaCaCaCaCaD
axauauauauavaiaiaiaiaiaCaCaCaCaCaiaCaCaCaCaCaCaCaCaCaCaCaD
axauauauauavaCaCaCaCaiaCaCaCaCaCaMaCaCaCaCaCaCaCaCaCaCaCaD
axauauauauavaCaCaCaiaiaCaCaCaCaCaiaiaiaiaCaCaCaCaCaNaOaPaQ
aNaPaPaRauavaCaCaCaiaCaCaCaCaCaCaCaCaSaiaFaCaCaCaCaTaUaVaW
aTaUaXaYaPaPaZaPaPaPaPaPbaaZaPaQaCaCaNaRaiaiaCaCaNaXbbaVaW
aTbbaVbcaVaVbbaVaVaVaUaVaVbbaXaVaPbdbeaYaPaPaPaPbebfaXaVaW
aTaVaVaVaVaVaVaUaVaVbbaVaVaVaVaUaVaVaVaVaVaVbgaVaVbbaVaVaW
aTaVaUaVaVaVaVbbaVaVaVaVaUaVaVbbaVaVaUaVaVaVbbaVaVaVaVaVaW
bhbibbbibibibibibibibiaVbbbibibibibibbbjbibibibibibibibibk
blbmbmbmbmbmbmbmbmbmbmbmbmbmbmbmbmbmbmbmbmbmbmbmbmbmbmbmbn
"}

(1,1,2) = {"
aaaQbobpbpbpbpbpbqbpbpbpbpbpbpbpbpbpbpbpbpbpbrbpbpbpbpbsbt
ahaWbubvaiaiaiaibwaiaiaiaiaiaiaiaiaiaiaiaiaiaiaiaiaiaCbxby
ahaWbuaCaiaiaiaiaiaiaiaiaiaiaiaiaiaiaiaiaiaiaiaiaiaiaCbxby
ahaWbuaCaiaCbzbzbzbzbzbAbzbzbBbzbzbzbzbzbzbzbzbzaCaibvbxby
ahaWbuaCbwaDbCbmbmbmbmbmbmbmbmbmbmbmbmbmbmbmbmbDbEbFbEbxby
ahaWbuaCaiaDbCauauauauauauauauauauauauauauauaubDaCaiaCbxby
aobkbuaCaiaDblbGbHbHbGbHbHbGbHbHbGbHbHbGbHbHbGbnaCaiaCbxby
axbDbuaCaiaDbIbJaCaCbJaCbKbLbMbMbLbMbMbNaCbObJaCaCaiaCbxby
axbDbubPaiaDbIaCaCbvaCaCaCbQbQbQbQbQbQbRaCaCaCaCaCaiaCbxby
blbnbSbEbFbxbIaCaiaiaiaiaibTaiaiaiaiaibTaiaiaiaiaiaiaCbxby
bUaiaiaiaiaDbIaCaiaCaCaCaCaCaCaCaCaCaiaCaCaCbVaCaCaCaCbxby
bUaiaiaiaiaDbIbPaiaCbVaCaCaCaCaCbVaCaiaCaCaCaCaCaCaCaCbxby
bWbzbzbzbzbXbobpbpbpbpbpbpbpbpbpbpbpbFbpbpbpbpbpbpbpbpbsby
bCbmbmbmbmbDbYaiaiaiaiaiaiaiaiaiaiaiaiaiaiaiaiaiaiaCaCbxby
bCauauauauavbZbzbzbzbzbzbzbzbzbzbzbzbzbzcabzbzbzaibzbzcbby
bmauauauauavbCbmbmbmbmbmbmbmbmbmbmbmbmbmbmbmbmbmaibmbmbDby
blbHbHbHbHbnbCbHbHbHbHbHbHbHbHbHbHbHbHbHbHbHbHbHbFbHbHbDby
bIaCaCaCaCaCaCaCaCaCaCaCaCaCaCaCaCaCaCaCaCaCaCaCaiaCaCccby
cdaiaiaiaiaiaiaiaiaiaiaiaiaiceaiaiaiaiaiaiaiaiaiaiaCaCcfby
cdaiaiaiaiaiaiaiaiaiceaiaiaiaiaiaiaiceaiaiaiaiaiaiaCaCcfby
bWbzbzbzbzbzbzbzbzbzbzbzbzbzbzbzbzbzbzbzbzbzbzbzbzbzbzcbby
bmbmbmbmbmbmbmbmbmbmbCbmbmbmbmbmbmbmbmbmbmbmbCbmbmbmbmbDby
azauawazaAaAaAaAaAaAaxaAaAaAaAaAaAaAaAaAaAaAaAaAauauauawby
bybybybybybybybybybybybybybybybybybybybybybybybybybybybyby
"}

(1,1,3) = {"
cgcgcgcgcgcgcgcgcgcgcgcgcgcgcgcgcgcgcgcgcgcgcgcgcgcgcgcgcg
chcicicicjcjcicjcjcicjcjcicicicicicicicicicickclclclclclcl
buaCcmaCbJbJaCbJbJaCbJbJaCaCaCaCaCcmaCaCaCaCaDclclclclclcl
buaCbJcnbzcabzbzbzbAbzbzbzcocabzcpcqcrbOaCaCaDclclclclclcl
csctbAbXaxayavaxauauayavaxauauavcsbzcabzbzbzbXclclclclclcl
axauauavaxayavaxauauayavaxauauavaxayayavaxauavclclclclclcl
axauauavaxayavazaAcuaBcvazcucuawaxayayavaxauavclclclclclcl
cwcucucvazcxawbMcybJcmbJaCbJbJaCazczczcvazaAawclclclclclcl
bLcAbLbLbMcBbMcCcyaCbJaCaCaCaCaCaCbJbJbJaCaCaDcgcgcgcgcgcg
bMbMbMbMbMbMbMbMcyaCaCaCaCbPaCaCaCaCaCaCaCaCaDcgcgcgcgcgcg
cDcDcDcDcDcDcDbQbRaCaCcEcFaCaCaCaCaCaCaCaCaCaDcgcgcgcgcgcg
cGaCaiaiaiaiaiaiaibOaCcHcIaCaCaCaCbvaCaCaCaCcJcJcJcJcJcKcJ
cLaiaiaCcMaCaCaCaiaCaCaCaCaCbOaCaiaiaiaiaiaicNcNcNcNcNcOcN
cGaCaCaCaCaCaCaCaiaiaiaiaiaiaiaiaiaCaCaCaCaCcJcJcJcJcJcKcJ
cEcFaCaCcPcQcRaCcMaCaCaCaCaCaCaCaCaCbOaCaCaCcNcNcNcNcNcOcN
cHcIaCaCbKcScyaCaCaCaCaCcPcTcQcQcRcmcmcmaCaCaDcgcgcgcgcgcg
cmcmcmcmbKcUcyaCcPcTcQcQcQbMcVbMcyaacWcXaCaCaDcgcgcgcgcgcg
aaababcYbKcUcZcZcZcZbMbMdabMbMbMaaaiakagaCaCaDcgcgcgcgcgcg
ahakaealababadacabcXdacZaacYbMdbahaeafagaCaCaDcgcgcgcgcgcg
ahafaiajakaiaiafaeaiabdcddalababddamaeagaCaCaDcgcgcgcgcgcg
ahaiaiaiafaiaiaiaiakaiaiaiaiaiaiaiafaiagaCaCaDcgcgcgcgcgcg
ahaiakaiaiaiakaiaiafaiaiakaiaiaiaiaiaiaiababcXcgcgcgcgcgcg
aoapafapapaiafapapapapapafarapapapapapapapapascgcgcgcgcgcg
azauauauauauauauauauauauauauauauauauauauauauawcgcgcgcgcgcg
"}
