"aa" = (/turf/Mountains/w6,/area)
"ab" = (/turf/Mountains/w6,/turf/Mountains/pl11,/area)
"ac" = (/turf/Mountains/mg12,/turf/EnemyStop{D = 1},/turf/Mountains/pl11,/area)
"ad" = (/turf/Mountains/mg12,/turf/EnemyStop,/turf/Mountains/pl11,/area)
"ae" = (/turf/Mountains/mg8,/turf/Mountains/pl9,/turf/EnemyStop{D = 1},/area)
"af" = (/turf/Mountains/mg7,/turf/Mountains/pl9,/area)
"ag" = (/turf/Mountains/mg8,/turf/EnemyStop{D = 1},/area)
"ah" = (/turf/Mountains/mg7,/turf/Mountains/pl11,/area)
"ai" = (/turf/Mountains/jap31,/area)
"aj" = (/turf/Mountains/mg7,/area)
"ak" = (/turf/Mountains/jap32,/area)
"al" = (/turf/Mountains/s9,/area)
"am" = (/turf/Mountains/jap37,/area)
"an" = (/turf/Mountains/jap34,/area)
"ao" = (/turf/Mountains/Black,/area)
"ap" = (/turf/Mountains/mg7,/turf/Mountains/pl9,/turf/Mountains/pl11,/area)
"aq" = (/turf/Mountains/mg2,/turf/Mountains/pl9,/area)
"ar" = (/turf/Mountains/mg3,/turf/EnemyStop{D = 1},/area)
"as" = (/turf/Mountains/m7,/turf/EnemyStop{D = 1},/area)
"at" = (/turf/Mountains/m8,/turf/EnemyStop{D = 1},/area)
"au" = (/turf/Mountains/m9,/turf/EnemyStop{D = 1},/area)
"av" = (/turf/Mountains/m2,/turf/EnemyStop{D = 1},/area)
"aw" = (/turf/Mountains/mg7,/turf/Mountains/pl5,/area)
"ax" = (/turf/Mountains/mg7,/turf/Mountains/pl2,/area)
"ay" = (/turf/Mountains/s9,/turf/Markers/VillageOne/ToVillageEntrance,/area)
"az" = (/turf/Mountains/p3,/area)
"aA" = (/turf/Mountains/p4,/turf/Mountains/pl5,/area)
"aB" = (/turf/Mountains/p1,/area)
"aC" = (/turf/Mountains/p2,/area)
"aD" = (/turf/Mountains/mg2,/area)
"aE" = (/turf/Mountains/s9,/turf/Markers/VillageOne/FromVillageOutskirtsToVillageCenter,/area)
"aF" = (/turf/Mountains/tg15,/area)
"aG" = (/turf/Mountains/tg14,/area)
"aH" = (/turf/Mountains/tg9,/area)
"aI" = (/turf/Mountains/tg7,/area)
"aJ" = (/turf/Mountains/tg7,/turf/Mountains/pl1,/area)
"aK" = (/turf/Mountains/tg7,/turf/Mountains/pl4,/area)
"aL" = (/mob/NPCS/QUEST,/turf/Mountains/mg7,/area)
"aM" = (/turf/Mountains/tg7,/turf/Mountains/pl2,/area)
"aN" = (/turf/Mountains/s9,/turf/Markers/VillageOne/ToVillageCenterFromVillageEntrance,/area)
"aO" = (/turf/Mountains/tg7,/turf/Mountains/pl3,/area)
"aP" = (/turf/Mountains/tg3,/area)
"aQ" = (/turf/Mountains/s9,/turf/Markers/VillageOne/ToVillageOutskirtsFromVillageCenter,/area)
"aR" = (/turf/Mountains/mg8,/area)
"aS" = (/turf/Mountains/s9,/turf/Markers/MercenaryQuest/MercQuest1_Outside,/area)
"aT" = (/turf/Mountains/mg8,/turf/Mountains/pl11,/area)
"aU" = (/turf/Mountains/mg8,/turf/Mountains/pl9,/area)
"aV" = (/turf/Mountains/s9,/turf/Markers/VillageOne/ToVillageOutskirtsFromArea2,/area)
"aW" = (/turf/Mountains/jap34,/turf/Mountains/pl11,/area)
"aX" = (/turf/Mountains/mg12,/turf/Mountains/pl9,/area)
"aY" = (/turf/Mountains/mg8,/turf/EnemyStop{D = 1},/turf/Mountains/pl11,/area)
"aZ" = (/turf/Mountains/mg8,/turf/EnemyStop{D = 1},/turf/Mountains/pl9,/area)
"ba" = (/turf/Mountains/s9,/turf/Mountains/pl9,/area)
"bb" = (/turf/Mountains/mg7,/turf/Mountains/pl11,/turf/Mountains/pl9,/turf/Mountains/pl11,/area)
"bc" = (/turf/Mountains/mg3,/turf/EnemyStop{D = 1},/turf/Mountains/pl9,/area)
"bd" = (/turf/Mountains/s9,/turf/Markers/VillageTwo/ToVillage2FromVillage2Outskirts,/area)
"be" = (/turf/Mountains/s9,/turf/Markers/VillageTwo/ToVillage2FromArea2,/area)
"bf" = (/turf,/area)
"bg" = (/turf/Mountains/s9,/turf/Markers/MercenaryQuest/MercQuest2_Outside,/area)
"bh" = (/turf/Mountains/s9,/turf/Markers/VillageTwo/ToVillage2OutskirtsFromVillage2,/area)

(1,1,1) = {"
aaaaaaaaaaaaaaaaaaaaaaaaaaaaaaaaaaaaaaaaaaaaaaaaaaaaaaaaab
acacadacacacacacacacacacacacacacacacacacacacacacacacacacae
afafafafafafafafafafafafafafafafafafafafafafafafafafafafag
ahahahahahahahahahahahahahahahahahahahahahahahahahahahahag
afafafafafafafafafafafafafafafafafafaiaiaiaiaiaiaiaiaiafag
ahahajajajajajajajajajajajajajajajajaiaiaiaiaiaiaiaiaiajag
afafajajajajajajajajajajajajajajajajakakakakakakakakakajag
alalalalalalalalalalalalalalajajajajamamamamamamamamamajag
ahahajajajajajajajajajajalalajajajajananananaoananananajag
apapahahahahahahahahahahalalahahahahahahahahahahahahahahag
aqaqaqaqaqaqaqaqaqaqaqaqalalaqaqaqaqaqaqaqaqaqaqaqaqaqaqar
asatatatatatatatatatatatalalatatatatatatatatatatatatatatau
asavavavavavavavavavavavalalavavavavavavavavavavavavavavau
ajajajajajajajajajajajajajalajajajajajajajajajajajajahahah
ajaiaiaiaiaiaiaiaiaiajajajalajawajajajajajajajaxajajafafaf
ajaiaiaiaiaiaiaiaiaiajajajalajajajajajajawajalalalalayalal
alaiaiaiaiaiaiaiaiaialalalalalalalalalalalalalajajajahahah
ajakakakakakakakakakajajajalajajajajajajajajajajajajafafaf
ajamamamamamamamamamajajajalajazaAajajajajajajajajajajajaj
ajananananaoananananajajajalajaBaCajajajajajajajajajajajaj
alalalalalalalalalalalalalalajajajajajajajajajajajajajajaj
aDaDaDaDaDaDaDaDaDaDaDaDaDaDaDaDaDaDaDaDaDaDaDaDaDaDaDaDaD
asatatatatatatatatatatatasatatatatasatatatatatatatatatatat
asavavavavavavavavavavavasavavavavasavavavavavavavavavavav
"}

(1,1,2) = {"
aaaaaaaaaaaaaaaaaaaaaaaaaaaaaaaaaaaaaaaaaaaaaaaaaaaaaaaaab
acacadacacacacacacacacacacacacacacacacacacacacacacacacacae
afaiaiaiaiaiaiafafafaiaiaiaiaiaiafafajaiaiaiaiaiaiajajafag
ahaiaiaiaiaiaiahahahaiaiaiaiaiaiahahajaiaiaiaiaiaiajajahag
afakakakakakakafafafakakakakakakafafajakakakakakakajajafag
ajamamamamamamajajajamamamamamamajajajamamamamamamajajajag
ajananananananajajajananananananajajajananananananajajajag
alalalalalalalalalalalalalalalalalalalalalalalalalalalaEal
ajajajajajajajajajajajajalalajajajajajajajajajajajajajajag
ajajajajajajajajajajajajalalajajajajajajajajajajajajajajag
ajajaiaiaiaiaiaiajajajajalalajajajajaiaiaiaiaiaiajajajajag
ajajaiaiaiaiaiaiajajajajalalajajajajakakakakakakajajajajag
ahahamamamamamamahahahahalalahahahahamamamamamamahahahahag
afafananananananafafafafalalafafafafananananananafafafafar
asatatatatatatatatatatatalalatatatatatatatatatatatatatatau
asavavavavavavavavavavavalalavavavavavavavavavavavavavavau
ajajajajajajajajajajajajalalajajajajajajawaFaGaGaGaGaGaGaG
ahahahahajajajajajajajajalalajajajajajajaHaIaJaIaIaKaIaIaK
afafafafajajajajajajajajalalajajajajaLajaHaIaMaIaIaMaIaIaM
alalaNalalalalalalalalalalalajajajajajajaHaIaOaIaIaOaIaIaO
ahahahahajajajajajajajajajajajajajajajajaHaIaIaIaIaIaIaIaI
afafafafajajajajajajajajajajajajajajajajajaPaPaPaPaPaPaPaP
aDaDaDaDaDaDaDaDaDaDaDaDaDaDaDaDaDaDaDaDaDaDaDaDaDaDaDaDaD
asatatatatatatatatatatatatatatatatasatatatatatatatatatatat
"}

(1,1,3) = {"
aaaaaaaaaaaaaaaaaaaaaaaaaaaaaaaaaaaaaaaaaaaaaaaaaaaaaaaaab
acacadacacacacacacacacacacacacacacacacacacacacacacacacacae
afafafafafafafafafafafafafafafafafafafafafafafafafafafafag
ahahahahahahahahahahahahahahahahahahahahahahahahahahahahag
afafafafafafafafafafafafafafafafafafafafafafafafafafafafag
ahahahahajajajajajajajajajajajajajajajajajajajajajajajajag
afafafafajajajajajajajajajajajajajajajajajajajajajajajajag
alalaQalalalalalalalalalalalajajajajajajajajajajajajajajag
ahahahahajajajajajajajajalalajaiaiaiaiaiaiaiaiaiaiaiaiaiag
apapapapahahahahahahahahalalajaiaiaiaiaiaiaiaiaiaiaiaiaiag
afafafafafafafafafafafafalalajaiaiaiaiaiaiaiaiaiaiaiaiaiaR
asatatatatatatatatatatatalalajaiaiaiaiaiaiaiaiaiaiaiaiaiaR
asaiaiaiaiaiaiavavavavavalalajaiaiaiaiaiaiaiaiaiaiaiaiaiaR
ajaiaiaiaiaiaiajajajajajalalajaiaiaiaiaiaiaiaiaiaiaiaiaiaR
ajamamamamamamajajajajajalalajamamamamamamamamamamamamamaR
ajananananananajajajajajalalajananananananaoananananananaR
ajajajalalajajajajajajajalalajajajajalalalaSalalalajajajaR
ajajajalalalalalalalalalalalajajajajajajajalajajajajajajaR
ajajajajajajajajajajajajalalalalalalalalalalajajajajajajaR
ajajajajajaiaiaiaiaiaiajalalahahahahahahahahahahahahahahaT
ajajajajajaiaiaiaiaiaiajalalafafafafafafafafafafafafafafaU
ajajajajajamamamamamamajalalalalalalalalalalalalalalalaVal
ahahahahahaWaWaWaWaWaWahahahahahahahahahahahahahahahahahaT
afafafafafafafafafafafafafafafafafafafafafafafafafafafafaU
"}

(1,1,4) = {"
ababababababababababababaaaaaaaaaaaaaaaaaaaaaaaaababababab
aXaXaXaXaXaXaXaXaXaXaXaXacacacacacacacacacacacacaXaXaXaXae
ahahahahahahahahahahahahafafafafafafafafafafafafahahahahaY
afafafafafafafafafafafafahahahaiaiaiaiaiaiaiaiaiafafafafaZ
ahahahahahahahahahahahahbababbaiaiaiaiaiaiaiaiaiahahahahaY
aqaqaqaqaqaqaqaqaqaqaqaqalalaqaiaiaiaiaiaiaiaiaiaqaqaqaqbc
asatatatatatatatatatatatalalatakakakakakakakakakatatatatau
asavavaiaiaiaiaiaiaiaiaiajalavakakakakakakakakakavavavavau
ajajajaiaiaiaiaiaiaiaiaiajalajakakakakakakakakakajajajajaj
ajajajaiaiaiaiaiaiaiaiaiajalajamamamamamamamamamajajajajaj
ajajajakakakakakakakakakajalajananananaoananananajajajajaj
ajajajamamamamamamamamamajalajajajajajajajajajajajajajajaj
ajajajananananaoananananajalajajajajajajajajajajajajajajaj
ajajajajajajajalajajajajajalajajajajajajajajajajajajajajaj
ajajajajajajajalajajajajajalalalalalalalalalalalalalalbdal
ajajajajajajajalajajajajajalajaiaiaiaiaiaiaiaiaiajajajajaj
albealalalalalalalalalalalalajaiaiaiaiaiaiaiaiaiajajahahah
ajajajajajajajajajajajajajalajaiaiaiaiaiaiaiaiaiajajafafaf
ajajajajajajajajajajajajajalajakakakakakakakakakajajajajaj
ajajajajajajajajajajajajajalajamamamamamamamamamajajajajaj
alalalalalalalalalalalalalalajananananaoananananajajajajaj
aDaDaDaDaDaDaDaDaDaDaDaDaDaDaDaDaDaDaDaDaDaDaDaDaDaDaDaDaD
asatatatatatatatatatatatasatatatatasatatatatatatatatatatat
asavavavavavavavavavavavasavavavavasavavavavavavavavavavav
"}

(1,1,5) = {"
bfbfbfbfbfbfbfbfbfbfbfbfbfbfbfbfbfbfbfbfbfbfbfbfbfbfbfbfbf
acacadacacacacacacacacacacacacacacacacacacacacacacacacacae
afafafafafafafafafafafafafafafafafafafafafafafafafafafafag
ahahahahahahahahahahahahahahahahahahahahahahahahahahahahag
afafafafafafafafafafafafafafafafafafafafafafafafafafafafag
ahahahaiaiaiaiaiaiaiaiaiaiaiaiaiaiaiaiaiaiaiaiaiaiaiaiaiag
apapapaiaiaiaiaiaiaiaiaiaiaiaiaiaiaiaiaiaiaiaiaiaiaiaiaiag
afafafaiaiaiaiaiaiaiaiaiaiaiaiaiaiaiaiaiaiaiaiaiaiaiaiaiag
asatataiaiaiaiaiaiaiaiaiaiaiaiaiaiaiaiaiaiaiaiaiaiaiaiaiag
asatataiaiaiaiaiaiaiaiaiaiaiaiaiaiaiaiaiaiaiaiaiaiaiaiaiag
ajajajaiaiaiaiaiaiaiaiaiaiaiaiaiaiaiaiaiaiaiaiaiaiaiaiaiaR
ajajajamamamamamamamamamamamamamamamamamamamamamamamamamaR
ajajajananananananananananananaoananananananananananananaR
ajajajajajajajajajajajajajajajbgajajajajajajajajajajajajaR
ajajajajajajajajajajajajajajajalajajajajajajajajajajajajaR
ajajajajajajajajajajajajajajajalajajajajajajajajajajajajaR
ajajajajajajajajajajajajajajajalajajajajajajajajajajajajaR
albhalalalalalalalalalalalalalalajajajajajajajajajajajajaR
ajajajajajajajajajajajajalajajajajajajajajajajajajajajajaR
ajajajajajaiaiaiaiaiaiajalajahahahahahahahahahahahahahahaT
ajajajajajaiaiaiaiaiaiajalajafafafafafafafafafafafafafafaU
ajajajajajamamamamamamajalalalalalalalalalalalalalalalalal
ahahahahahaWaWaWaWaWaWahahahahahahahahahahahahahahahahahaT
afafafafafafafafafafafafafafafafafafafafafafafafafafafafaU
"}
