"a" = (/turf,/area)
"b" = (/turf/Mountains/s11,/turf/Darkness/Cave_Dark,/area)
"c" = (/turf/Mountains/s12,/turf/Darkness/Cave_Dark,/area)
"d" = (/turf/Mountains/s13,/turf/Darkness/Cave_Dark,/area)
"e" = (/turf/Mountains/s8,/turf/Darkness/Cave_Dark,/area)
"f" = (/turf/Mountains/s9,/turf/Darkness/Cave_Dark,/area)
"g" = (/turf/Mountains/s10,/turf/Darkness/Cave_Dark,/area)
"h" = (/turf/Mountains/s5,/turf/Darkness/Cave_Dark,/area)
"i" = (/turf/Mountains/s7,/turf/Darkness/Cave_Dark,/area)
"j" = (/turf/Mountains/s6,/turf/Darkness/Cave_Dark,/area)
"k" = (/turf/Mountains/m7,/turf/Darkness/Cave_Dark,/area)
"l" = (/turf/Mountains/m8,/turf/Darkness/Cave_Dark,/area)
"m" = (/turf/Mountains/m9,/turf/Darkness/Cave_Dark,/area)
"n" = (/turf/Mountains/m4,/turf/Darkness/Cave_Dark,/area)
"o" = (/turf/Mountains/m6,/turf/Darkness/Cave_Dark,/area)
"p" = (/turf/Mountains/s9,/turf/Darkness/Cave_Dark,/turf/Markers/Mountains/Dungeon1_Inside,/area)
"q" = (/turf/Mountains/s9,/turf/Darkness/Cave_Dark,/turf/Locations/Dungeons/Dungeon1_Outside,/area)

(1,1,1) = {"
aaaaaaaaaaaaaaaaaaaaaaaaaaaaaaaaaaaaaaaaaaaaaaaaaaaaaaaaaaaaaaaaaaaaaa
aaaaaaaaaaaaaaaaaaaaaaaaaaaaaaaaaaaaaaaaaaaaaaaaaaaaaaaaaaaaaaaaaaaaaa
aaaaaaaaaaaaaaaaaaaaaaaaaaaaaaaaaaaaaaaaaaaaaaaaaaaaaaaaaaaaaaaaaaaaaa
aaaaaaaaaaaaaaaaaaaaaaaaaaaaaaaaaaaaaaaaaaaaaaaaaaaaaaaaaaaaaaaaaaaaaa
aaaaaaaaabccccccccccccccdaaaaaaaaaaaaabccccccccccccccdaaaaaaaaaaaaaaaa
aaaaaaaaaeffffffffffffffgaaaaaaaaaaaaaeffffffffffffffgaaaaaaaaaaaaaaaa
aaaaaaaaaeffffffffffffffgaaaaaaaaaaaaaeffffffffffffffgaaaaaaaaaaaaaaaa
aaaaaaaabffffffffffffffffdaaaaaaaaaaabffffffffffffffffdaaaaaaaaaaaaaaa
aaaaaaaahffffffffffffffffiaaaaaaaaaaahffffffffffffffffiaaaaaaaaaaaaaaa
aaaaaaaaaeffffffffffffffgaaaaaaaaaaaaaeffffffffffffffgaaaaaaaaaaaaaaaa
aaaaaaaaaeffffffffffffffgaaaaaaaaaaaaaeffffffffffffffgaaaaaaaaaaaaaaaa
aaaaaaaaahjjjjjjjjjjjjjjiaaaaaaaaaaaaahjjjjjjjjjjjjjjiaaaaaaaaaaaaaaaa
aaaaaaaaaaaaaaaaaaaaaaaaaaaaaaaaaaaaaaaaaaaaaaaaaaaaaaaaaaaaaaaaaaaaaa
aaaaaaaaaaaaaaaaaaaaaaaaaaaaaaaaaaaaaaaaaaaaaaaaaaaaaaaaaaaaaaaaaaaaaa
aaaaaaaaaaaaaaaaaaaaaaaaaaaaaaaaaaaaaaaaaaaaaaaaaaaaaaaaaaaaaaaaaaaaaa
aaaaaaaaaaaaaaaaaaaaaaaaaaaaaaaaaaaaaaaaaaaaaaaaaaaaaaaaaaaaaaaaaaaaaa
aaaaaaaaaaaaaaaaaaaaaaaaaaaaaaaaaaaaaaaaaaaaaaaaaaaaaaaaaaaaaaaaaaaaaa
aaaaaaaaabccccccccccccccdaaaaaaaaaaaaabccccccccccccccdaaaaaaaaaaaaaaaa
aaaaaaaaaeffffffffffffffgaaaaaaaaaaaaaeffffffffffffffgaaaaaaaaaaaaaaaa
aaaaaaaaaeffffffffffffffgaaaaaaaaaaaaaeffffffffffffffgaaaaaaaaaaaaaaaa
aaaaaaaabffffffffffffffffdaaaaaaaaaaabffffffffffffffffdaaaaaaaaaaaaaaa
aaaaaaaahffffffffffffffffiaaaaaaaaaaahffffffffffffffffiaaaaaaaaaaaaaaa
aaaaaaaaaeffffffffffffffgaaaaaaaaaaaaaeffffffffffffffgaaaaaaaaaaaaaaaa
aaaaaaaaaeffffffffffffffgaaaaaaaaaaaaaeffffffffffffffgaaaaaaaaaaaaaaaa
aaaaaaaaahjjjjjjjjjjjjjjiaaaaaaaaaaaaahjjjjjjjjjjjjjjiaaaaaaaaaaaaaaaa
aaaaaaaaaaaaaaaaaaaaaaaaaaaaaaaaaaaaaaaaaaaaaaaaaaaaaaaaaaaaaaaaaaaaaa
aaaaaaaaaaaaaaaaaaaaaaaaaaaaaaaaaaaaaaaaaaaaaaaaaaaaaaaaaaaaaaaaaaaaaa
aaaaaaaaaaaaaaaaaaaaaaaaaaaaaaaaaaaaaaaaaaaaaaaaaaaaaaaaaaaaaaaaaaaaaa
aaaaaaaaaaaaaaaaaaaaaaaaaaaaaaaaaaaaaaaaaaaaaaaaaaaaaaaaaaaaaaaaaaaaaa
aaaaaaaaaaaaaaaaaaaaaaaaaaaaaaaaaaaaaaaaaaaaaaaaaaaaaaaaaaaaaaaaaaaaaa
aaaaaaaaaaaaaaaaaaaaaaaaaaaaaaaaaaaaaaaaaaaaaaaaaaaaaaaaaaaaaaaaaaaaaa
aaaaaaaaaaaaaaaaaaaaaaaaaaaaaaaaaaaaaaaaaaaaaaaaaaaaaaaaaaaaaaaaaaaaaa
aaaaaaaaabccccccccccccccdaaaaaaaaaaaaabccccccccccccccdaaaaaaaaaaaaaaaa
aaaaaaaaaeffffffffffffffgaaaaaaaaaaaaaeffffffffffffffgaaaaaaaaaaaaaaaa
aaaaaaaaaeffffffffffffffgaaaaaaaaaaaaaeffffffffffffffgaaaaaaaaaaaaaaaa
aaaaaaaabffffffffffffffffdaaaaaaaaaaabffffffffffffffffdaaaaaaaaaaaaaaa
aaaaaaaahffffffffffffffffiaaaaaaaaaaahffffffffffffffffiaaaaaaaaaaaaaaa
aaaaaaaaaeffffffffffffffgaaaaaaaaaaaaaeffffffffffffffgaaaaaaaaaaaaaaaa
aaaaaaaaaeffffffffffffffgaaaaaaaaaaaaaeffffffffffffffgaaaaaaaaaaaaaaaa
aaaaaaaaahjjjjjjjjjjjjjjiaaaaaaaaaaaaahjjjjjjjjjjjjjjiaaaaaaaaaaaaaaaa
aaaaaaaaaaaaaaaaaaaaaaaaaaaaaaaaaaaaaaaaaaaaaaaaaaaaaaaaaaaaaaaaaaaaaa
aaaaaaaaaaaaaaaaaaaaaaaaaaaaaaaaaaaaaaaaaaaaaaaaaaaaaaaaaaaaaaaaaaaaaa
aaaaaaaaaaaaaaaaaaaaaaaaaaaaaaaaaaaaaaaaaaaaaaaaaaaaaaaaaaaaaaaaaaaaaa
aaaaaaaaaaaaaaaaaaaaaaaaaaaaaaaaaaaaaaaaaaaaaaaaaaaaaaaaaaaaaaaaaaaaaa
aaaaaaaaaaaaaaaaaaaaaaaaaaaaaaaaaaaaaaaaaaaaaaaaaaaaaaaaaaaaaaaaaaaaaa
aaaaaaaaaaaaaaaaaaaaaaaaaaaaaaaaaaaaaabccdbccdbccdbcccdaaaaaaaaaaaaaaa
aaaaaaaaaaaaaaaaaaaaaaaaaaaaaaaaaaaaaaeffghjjieffgefffgaaaaaaaaaaaaaaa
aaaaaaaaabccccccccccccccdaaaaaaaaaaaaahjjikllmhjjihjjjiaaaaaaaaaaaaaaa
aaaaaaaaaeffffffffffffffgaaaaaaaaaaaaakllmnllokllmklllmaaaaaaaaaaaaaaa
aaaaaaaaaefffffffffffffffdaaaaaaaaaaaanlloffffnllonllloaaaaaaaaaaaaaaa
aaaaaaaaaefffffffffffffffiaaaaaaaaaaaaefffffffffffffffgaaaaaaaaaaaaaaa
aaaaaaaaaeffffffffffffffgaaaaaaaaaaaaaefffffffffffffffgaaaaaaaaaaaaaaa
aaaaaaaaaeffffjjjjjjjjjjiaaaaaaaaaaaabfffffffffffffffffdaaaaaaaaaaaaaa
aaaaaaaaaefffgaaaaaaaaaaaaaaaaaaaaaaahfffffffffffffffffiaaaaaaaaaaaaaa
aaaaaaaaaefffgaaaaaaaaaaaaaaaaaaaaaaaaefffffffffffffffgaaaaaaaaaaaaaaa
aaaaaaaaaefffgaaaaaaaaaaaaaaaaaaaaaaaaefffffffffffffffgaaaaaaaaaaaaaaa
aaaaaaaaaefpfgaaaaaaaaaaaaaaaaaaaaaaaahjjjjjjjjjjjjjjjiaaaaaaaaaaaaaaa
aaaaaaaaahjqjiaaaaaaaaaaaaaaaaaaaaaaaaaaaaaaaaaaaaaaaaaaaaaaaaaaaaaaaa
aaaaaaaaaaaaaaaaaaaaaaaaaaaaaaaaaaaaaaaaaaaaaaaaaaaaaaaaaaaaaaaaaaaaaa
aaaaaaaaaaaaaaaaaaaaaaaaaaaaaaaaaaaaaaaaaaaaaaaaaaaaaaaaaaaaaaaaaaaaaa
aaaaaaaaaaaaaaaaaaaaaaaaaaaaaaaaaaaaaaaaaaaaaaaaaaaaaaaaaaaaaaaaaaaaaa
aaaaaaaaaaaaaaaaaaaaaaaaaaaaaaaaaaaaaaaaaaaaaaaaaaaaaaaaaaaaaaaaaaaaaa
aaaaaaaaaaaaaaaaaaaaaaaaaaaaaaaaaaaaaaaaaaaaaaaaaaaaaaaaaaaaaaaaaaaaaa
aaaaaaaaaaaaaaaaaaaaaaaaaaaaaaaaaaaaaaaaaaaaaaaaaaaaaaaaaaaaaaaaaaaaaa
aaaaaaaaaaaaaaaaaaaaaaaaaaaaaaaaaaaaaaaaaaaaaaaaaaaaaaaaaaaaaaaaaaaaaa
"}
